####################################################################################################
##......[]......[]####....######..[]............[]......[]##..[][]####....[]##........[][]##[][]..##
##......[][]................[]....[]..####....[]......[]......##........[][]....##..............[]##
##[]..........[]....##..........[]....[][]##[][]..##[]....[][][]..##..##..........................##
##............##[][][]..[]..[][]........##..##....[][][][]..[][]..[]##[]....[]....[]....####......##
##..[]########..[]......[][]..[]..##..[][]..[]##[]..[][]##........................[]##..[]##......##
##........[]..##....................##[]......[]..[][]##[]..##........##....[]..[][]........[]..####
##[]....##......[]......[]..[][][][]..[]................[]....[][]..[]........[]..[]##........[]..##
####[]................##[]..[]..[]..####..##....[][]##........[]....[]............##........[]..[]##
##......##[][]..[][][]....##..[]....[]....####......##......[]##[]....[]..................[]......##
##..##[]##........##..##........##..[]....[][]##..........##......[][]##[]......[]..##[]........[]##
##..................[]##[]##[][][]........[]..[]................[][]....##....[]..[][][]..##[]..[]##
##[]..##..##..[]....##..[]................##..[][]##..........[]................[][]..[]..[]..[]..##
##....[]..[]........[]..[]..................##......[]..[]....[][][]....[]......[]......[]........##
##..........[]............[][]........##....[]..[]..[]..........................[]......##....[]..##
##....[][]##........##......[]....................[]..............[]....##........................##
##[][][]..[]......##........[]......[][]......[]..[]......[][]####................##[]............##
##......[]..[][][][]..........[][]........##..[]..[]..........[]..........................[]....[]##
##..[]##........[][]..##........[]..##..........##........##......[][][]................[]....[]..##
##[]..[]....##..##[]......[]##......[]..........[][]....##........[]......[]....####..[]........[]##
##[]..[][]..........##[]........[]....[][][]..........[]....##..........[]....[]......[]..[][]..[]##
##......[]##..##[]......[][]..[]......[][]....[]....[]....[]..##[][]........##......[]......##[][]##
##[]....[]........[][]..[]......##......[]............##[]....##[][]..[]....[][]##[]..............##
##..[]........................[]##[][]..[]..##......####..[]........[]..[]....[]..........[][]....##
##....[][][][][][][]....[]..[]......[][][]......@...[][][]##..[]........##..........[][]........[]##
##....##........[]....................##[]....##..........[]....[]....[]..[]........[][]......[]..##
##[]..[]....[][]..[]....[][]..[]..[]..####....[][]....[][]....[]##....[][][][]..[]....[]......##[]##
##..##..................[][]..[][]....................####......[][]......##[][]....##[]......[]..##
##........[]......[]............[]##..[]..[][]....##..[]........[]......[]........[][]..[][]##....##
####....[]..........[][]....[]..[]........[]##....[]......##....................[][]##[]..[]..[][]##
##[][]..[][]....[][]..[][]....[][]..[]............[]##[][]....[][][][][]............##....##..##..##
##[][]..##..[]##[]##..####..[]....[]##........[]......[]........[]..##[]........##....[]....[]..[]##
##..[][]..##[][]..[][]..[]##....[][][][]..##....................[]..........[][]........[]..[]....##
##[]............[][]....##....[]..[][]..[][]..[][]........##[]..[]##..........[][]####..##........##
##[]..[][]....[]....##..........[]..........[]............##..........##............[]##..........##
##..[]........[]##..[][]....[]............[]....[]..[]..........[]####....[][]..[]....##..........##
##....##............[][]..........##....[][]..[]....##........[][]..[]..............##..##[]..[]..##
##......##..[][]....[][]............[]..##[]..[][]##..[]..##[][]..........[][]..##........[]..[]..##
##........[][]..[][]....[]..[]..[]..##..[][]....[]............[]................[]....##..##[]....##
##....[]..##....[]....##..[]..##..[]........[][]............[][]..[]....................##..[][][]##
##[]........##[]..........[][]##..........[]..[]....##........[]....##[]......[]....[][]........[]##
##......[]....##[]............[]##....##....[]....##..................[]....[]......[]..[][]......##
##........[]##....##..[]................[]..[]......##......[]..........[]##[]..[]..[]........[]..##
##..[]....[][]........##[][]........[]........[]##....[]..........[]....[][]####..........[]..######
##..##....[]##[]................[]##[]....[]##......[]..........[]##[]......[]####....[]..[]......##
##......##....[]......[]....##[]..[][]......##..[][]..[]..........[][]......[][][]..[][]....##....##
##[]..................................##........##[]................[]....##..........[][]........##
##..##....................[]..[][]....[]..........................[]....[]....[]##....[]..[]......##
##................##..........[]..........[]....##....[]##....##..[][]..[]............[]..##..[][]##
####################################################################################################
####################################################################################################
##......[]......[]####..[]######..[]............[]......[]##..[][]####.[].[]##........[][]##[][]..##
##......[][]..............[][][][][]..####....[]......[]......##.........[][]...##..............[]##
##[]..........[]....##.[][]...........[][]##[][]..##[]....[][][]..##..##..........................##
##............##[][][]..................##..##....[][][][]..[][]..[]##[]..........[]....####......##
##..[]########..[]..........[]....##..[][]..[]##[]..[][]##......[]............[]..[]##..[]##......##
##........[]..##.................[].##[]......[]..[][]##[][]##........##..[].....[][].......[]..####
##[]....##..[]..............[][][][]..[]......................[]....[]............[]##[]......[]..##
####[]................##.....[]..[].####..##....[][]##.........[]...[]..........[]##..[]....[]..[]##
##......##[][][]..[]......##[].[]...[]....####..[]..##........##.[].[]..............[]....[]......##
##..##[]##......[]##..##......[]##..[]..[][][]##..........##....[][]..##[].....[]...##..........[]##
##..................[]##..##.......[].......[][]............[]..[][]....##........[][]..[]##[]..[]##
##[]..##..##..[]....##..[].[].............##[]....##.....[]...[]...........................[].[]..##
##....[]..[]............[]..[]..............##.........[][].[][][]..........................[]....##
##..........[].....[].................##............[]..............[]....[]............##....[]..##
##....[][]##........##............................[]....................##........................##
##[][][]..[]....[]##.................@.....[].....[]......[][]####..............[]##..............##
##......[]..[][]...[].....[].[].......[]..##..[]..[]..........[][]....[]............[]....[]....[]##
##..[]##....[][]......##....[]......##........[]##........##...[]...[][]................[]....[]..##
##[]..[]....##..##..........##[]......[]........[]......##........[]....[][]..[]####..[]........[]##
##[]..[][]......[]..##.....[][][]..................[].......##....[]......[][][]......[]..[][]..[]##
##......[]##[]##...[].....[].[]..[].................[][]......##..[]........##[]....[]......##[][]##
##[]....[][].........[]..[].[][]##[][].....[].[]......##......##..[]........[][]##[]..............##
##..[].[]................[][].[]##[].[]...[]##[]....####[].....[].[]..........[][][]......[][]....##
##[][][]..................[][].......[][][][].[]....[][][]##......[]....##......[]..[][]........[]##
##....##..................[][]......[]##[][]..##........[][]................[][][]..[][]......[]..##
##[][][]...............[][][][].......####......[][]..[][]......##........[][]........[]......##[]##
##..##............[]....[].[].[][]....[]..............####............[]..##........##[]......[]..##
##................[][][][]..[][][]##.[].....[]....##[][][][].........[]........[].[][]..[][]##....##
####.[]....[].....[].[].[]...[].[][].[].....##....[][][][]##......................[]##[]..[]..[][]##
##[][]...[].[]....[]...[][].[]..[][]..............[]##[]..........................[]##....##..##..##
##[][][]##....##..##..####.[]..[].[]##.[]...[]...............[][]...##........[]##....[]....[]..[]##
##..[][]..##.......[].[][]##...[].[]..[]..##.................[][][][].............[][]..[]..[]....##
##[]..............[][][]##[]..[][]..........[]............##....[]##..............####..##........##
##[][][]........[]..##[].[][]................[][].........##........[]##........[]..[]##..........##
##..[]......[]..##.....[][][]...............[][]...............[].####........[]......##..........##
##....##[].....[]........[].[]....##........[][]..[]##...........[].[]..[]....[][]..##..##[]..[]..##
##......##...............[].............##........##......##....[][].[].......[]##........[]..[]..##
##..[][][][]........................##...[]..................[][].....[]......[][]....##..##[]....##
##....[]..##[][]......##......##........................................................##..[][][]##
##[]......[]##[]..............##[].....[]...........##..........[]..##................[][]......[]##
##.....[].....##[]............[]##....##..........##....................................[][]......##
##..........##[][]##[]..............[]..........[][]##.[].................##[].[]...[]........[]..##
##..[].......[].......##............[].....[][].##........................[]####[]..[]....[]..######
##..##[][]..##.[].................##....[][]##................[]..##..[]....[]####....[]..[]......##
##......##..................##[]........[][]##....................[][].[]....[][][].[][]....##....##
##[].....[]..............[].......[]..##[][]..[]##..........[][][]..[]..[]##..[]......[][]........##
##..##............[][]....[]........[]...[][][][][]...[]......[][][][]..[]......##....[]..[]......##
##................##[][]............[]....[]..[]##[]..[]##..[]##[][][]..[]............[]..##..[][]##
####################################################################################################
