##################################################
#...O...O##..###.O......O...O#.OO##..O#....OO#OO.#
#...OO........O..O.##..O...O...#....OO..#.......O#
#O.....O..#.....O..OO#OO.#O..OOO.#.#.............#
#......#OOO.O.OO....#.#..OOOO.OO.O#O..O..O..##...#
#.O####.O...OO.O.#.OO.O#O.OO#............O#.O#...#
#....O.#..........#O...O.OO#O.#....#..O.OO....O.##
#O..#...O...O.OOOO.O........O..OO.O....O.O#....O.#
##O........#O.O.O.##.#..OO#....O..O......#....O.O#
#...#OO.OOO..#.O..O..##...#...O#O..O.........O...#
#.#O#....#.#....#.O..OO#.....#...OO#O...O.#O....O#
#.........O#O#OOO....O.O........OO..#..O.OOO.#O.O#
#O.#.#.O..#.O........#.OO#.....O........OO.O.O.O.#
#..O.O....O.O.........#...O.O..OOO..O...O...O....#
#.....O......OO....#..O.O.O.............O...#..O.#
#..OO#....#...O..........O.......O..#............#
#OOO.O...#....O...OO...O.O...OO##........#O......#
#...O.OOOO.....OO....#.O.O.....O.............O..O#
#.O#....OO.#....O.#.....#....#...OOO........O..O.#
#O.O..#.#O...O#...O.....OO..#....O...O..##.O....O#
#O.OO.....#O....O..OOO.....O..#.....O..O...O.OO.O#
#...O#.#O...OO.O...OO..O..O..O.#OO....#...O...#OO#
#O..O....OO.O...#...O......#O..#OO.O..OO#O.......#
#.O............O#OO.O.#...##.O....O.O..O.....OO..#
#..OOOOOOO..O.O...OOO...@.OOO#.O....#.....OO....O#
#..#....O..........#O..#.....O..O..O.O....OO...O.#
#O.O..OO.O..OO.O.O.##..OO..OO..O#..OOOO.O..O...#O#
#.#.........OO.OO..........##...OO...#OO..#O...O.#
#....O...O......O#.O.OO..#.O....O...O....OO.OO#..#
##..O.....OO..O.O....O#..O...#..........OO#O.O.OO#
#OO.OO..OO.OO..OO.O......O#OO..OOOOO......#..#.#.#
#OO.#.O#O#.##.O..O#....O...O....O.#O....#..O..O.O#
#.OO.#OO.OO.O#..OOOO.#..........O.....OO....O.O..#
#O......OO..#..O.OO.OO.OO....#O.O#.....OO##.#....#
#O.OO..O..#.....O.....O......#.....#......O#.....#
#.O....O#.OO..O......O..O.O.....O##..OO.O..#.....#
#..#......OO.....#..OO.O..#....OO.O.......#.#O.O.#
#...#.OO..OO......O.#O.OO#.O.#OO.....OO.#....O.O.#
#....OO.OO..O.O.O.#.OO..O......O........O..#.#O..#
#..O.#..O..#.O.#.O....OO......OO.O..........#.OOO#
#O....#O.....OO#.....O.O..#....O..#O...O..OO....O#
#...O..#O......O#..#..O..#.........O..O...O.OO...#
#....O#..#.O........O.O...#...O.....O#O.O.O....O.#
#.O..OO....#OO....O....O#..O.....O..OO##.....O.###
#.#..O#O........O#O..O#...O.....O#O...O##..O.O...#
#...#..O...O..#O.OO...#.OO.O.....OO...OOO.OO..#..#
#O.................#....#O........O..#.....OO....#
#.#..........O.OO..O.............O..O..O#..O.O...#
#........#.....O.....O..#..O#..#.OO.O......O.#.OO#
##################################################
